{
    "1": 1,
    "2": 2,
    "3": 3,
    "4": 4,
    "5": 5,
    "6": 6,
    "7": 7,
    "8": 8,
    "9": 9,
    "10": 118,
    "11": 119,
    "12": 15,
    "13": 18,
    "14": 19,
    "15": 20,
    "16": 21,
    "17": 22,
    "18": 25,
    "19": 121,
    "20": 120,
    "21": 79,
    "22": 51,
    "23": 52,
    "24": 63,
    "25": 64,
    "26": 65,
    "27": 66,
    "28": 67,
    "29": 68,
    "30": 69,
    "31": 70,
    "32": 71,
    "33": 72,
    "34": 73,
    "35": 74,
    "36": 75,
    "37": 76,
    "38": 77,
    "39": 78,
    "40": 80,
    "41": 81,
    "42": 82,
    "43": 83,
    "44": 84,
    "45": 85,
    "46": 86,
    "47": 87,
    "48": 88,
    "49": 89,
    "50": 90
}